+++++++@++@O@@@+
+@@@@@+@++@@@+@+
+@+++@+@+++@++@+
+@+++@@@@@@@O+@+
+++@@@+++++O1O@+
@@@@++++@@@@@@@+
++++++++++++++@+
2@@@@+@@@@2+@@@+
++++OX@++++++@++
+++++++@@@@@@@@@