@@@@@+@@@@@@@@@@
+@++@+@++O+@+@+@
+@++@@@++++@@@+@
++@@@++@@@@@+++@
+++@++++@O+@@@+@
++O@@@@@@+++@+@@
+++++@++++OO@O+@
+++++@++++O@@@O@
+++++@++++O@O@O@
++2+++++++O@@@O@
++@++++++++O1OO@
++X+++++++++++++