+++++@++++++++++
+++@@@@@++++++++
++X++++@@@@+++++
++@@@@@@++++++++
++++++++++++++++
++++++++++++++++
++++++++++++++++
++++++++++++++++
++++++++++++++++
++++++++++++++++
++++++++++++++++
++++++++++++++++